NO textures/lava.xpm
SO textures/wall_brick.xpm
WE textures/tree.xpm
EA textures/honey.xpm

F 1,0,0

C 173,216,230


1111111111111111111111111
1000000000110000000000001
1011000001110000000000001
100100000000000000000000111111111
111111111011000001110000000000001
100000000011000001110111111111111
11110111111111011100000010001
111101111111110101101010010011111
11N00000110101011100000010001
10000000000000001100000010001
10000000000000001101010010001
110000011101010111110111100011111
11110111 1110101 10111101000000001
11111111 1111111 1111111111111111